Дать определение умножения матриц. Коммутативна ли эта операция?	Определение. Рассмотрим A типа \(n \to p\) и B типа \(p \to k\). Произведением матриц A и B называется матрица C типа \(n \to k\) с элементами \(c_{ij} = \sum_{l=1}^{p} a_{il} \cdot b_{lj}, \forall i = 1, n, j = 1, k\). Замечание. Операция умножения матриц не является коммутативной. Пример. \(A = \begin{pmatrix} 1 & 1 \\ 0 & 0 \end{pmatrix}, B = \begin{pmatrix} 0 & 0 \\ 1 & 1 \end{pmatrix}\). \(A \cdot B = \begin{pmatrix} 1 & 1 \\ 0 & 0 \end{pmatrix} = A\). \(B \cdot A = \begin{pmatrix} 0 & 0 \\ 1 & 1 \end{pmatrix} = B\). \(A \cdot B \neq B \cdot A\)
Дать определение ступенчатого вида матрицы и канонического (элементарного ступенчатого) вида матрицы.	Определение. Матрица M имеет ступенчатый вид, если номера столбцов первых ненулевых элементов всех строк (такие элементы удобно называть ведущими) возрастают, а нулевые строки расположены в нижней части матрицы. Определение. Матрица M имеет улучшенный ступенчатый (канонический) вид, если: 1) она имеет ступенчатый вид 2) все ведущие элементы равны 1 3) в столбце с ведущим элементом все остальные элементы равны 0
Перечислить элементарные преобразования строк матрицы.	Определение. Элементарными преобразованиями строк матрицы называют: 1) умножение i-ой строки матрицы на \(\omega \neq 0\): \(\omega \cdot (i) \leftrightarrow (i)\) 2) перестановку двух строк в матрице: \((i) \leftrightarrow (k)\) 3) добавление к i-ой строке k-ой строки с коэффициентом \(\omega\): \((i) + \omega \cdot (k) \leftrightarrow (i)\)
Сформулировать теорему о методе Гаусса.	Утверждение. Любую конечную матрицу можно элементарными преобразованиями привести к ступенчатому (каноническому) виду.
Дать определение перестановки и подстановки.	Определение. Всякое расположение чисел \(1,...,n\) в определённом порядке называют перестановкой \(\omega = (\omega_1,...,\omega_n)\). Определение. Подстановкой называется взаимно-однозначное отображение \(1,...,n\) в себя: \(\varepsilon = \begin{pmatrix} 1 & ... & n \\ \varepsilon(1) & ... & \varepsilon(n) \end{pmatrix}\). Здесь \((\varepsilon(1),...,\varepsilon(n))\) – перестановка.
Вывести формулу вычисления определителя произвольного порядка.	Определение. Определителем (детерминантом) порядка n, соответствующим квадратной матрице A называется число, являющееся суммой n! слагаемых: \(\det A = \sum_{\omega \in S_n} \text{sgn } \varepsilon \cdot a_{1\omega(1)} \cdot a_{2\omega(2)} \cdot ... \cdot a_{n\omega(n)}\)
Вывести формулы для разложения определителя по строке и по столбцу.	Разложение по строке (столбцу): Для любого фиксированного j справедливо: \(\det A = \sum_{i=1}^{n} a_{ij}A_{ij}\) – разложение по столбцу. Для любого фиксированного i справедливо: \(\det A = \sum_{j=1}^{n} a_{ij}A_{ij}\) – разложение по строке.
Вывести формулу Крамера для квадратной матрицы произвольного порядка. Когда с её помощью можно найти решение СЛАУ?	Утверждение. Пусть \(Ax = b\) совместная СЛАУ, тогда: \(x_i \cdot \det A = \Delta_i\), где \(\Delta_i = \det(A_1, ..., A_{i-1}, b, A_{i+1}, ..., A_n)\). Если \(\det A \neq 0\), то \(x_i = \frac{\Delta_i}{\det A}, i = 1, n\).
Дать определение обратной матрицы. Сформулировать критерий её существования.	Определение. Обратной к квадратной матрице \(A \in M_n(\mathbb{R})\) называется матрица \(A^{-1} : A \cdot A^{-1} = E = A^{-1} \cdot A\). Утверждение. \(\exists A^{-1} \Leftrightarrow \det A \neq 0\).
Вывести формулу для нахождения обратной матрицы.	Формула: \(A^{-1} = \frac{1}{\det A} \cdot A^*\).
Вывести формулу для матрицы обратной к произведению двух матриц.	Формула: \((A \cdot B)^{-1} = B^{-1} \cdot A^{-1}\).
Дать определение минора.	Определение. Минором k-го порядка матрицы A называют определитель матрицы, составленной из элементов, стоящих на пересечении произвольных k строк и k столбцов из матрицы A.
Дать определение базисного минора. Какие строки называются базисными?	Определение. Любой отличный от нуля минор порядка которого равен рангу, называется базисным минором матрицы. Строки, которые попали в базисный минор, называются базисными.
Дать определение ранга матрицы.	Определение. Рангом матрицы называют наивысший порядок отличного от 0 минора. Определение означает, что: 1) \(\exists M_{i_1...i_r}^{j_1...j_r} \neq 0\) (минор r-го порядка \(r = \text{Rg } A\)) 2) все миноры порядков \(r + 1, r + 2,...\) равны 0 (или не существуют).
Дать определение линейной комбинации строк. Что такое нетривиальная линейная комбинация?	Определение. Линейной комбинацией строк (или столбцов) \(a_1,...,a_s\) одинаковой длины называют выражение вида: \(\omega_1a_1 + \omega_2a_2 + ... + \omega_sa_s = \sum_{k=1}^{s} \omega_ka_k\), где \(\omega_1,...,\omega_s\) – некоторые числа. Определение. Линейная комбинация \(\omega_1a_1 + \omega_2a_2 + ... + \omega_sa_s\) называется нетривиальной, если \(\omega_1,...,\omega_s\) не все равны 0.
Дать определение линейной зависимости строк матрицы.	Определение. Строки \(a_1,...,a_s\) называют линейно зависимыми, если существуют числа \(\omega_1,...,\omega_s\) не все равные 0, такие, что \(\omega_1a_1 + \omega_2a_2 + ... + \omega_sa_s = 0\)
Дать определение линейно независимых столбцов матрицы.	Определение. Если равенство \(\omega_1a_1 + \omega_2a_2 + ... + \omega_sa_s = 0\) возможно только в случае, когда \(\omega_1 = ... = \omega_s = 0\), то столбцы матрицы \(a_1,...,a_s\) называют линейно независимыми.
Сформулировать критерий линейной зависимости.	Утверждение. \(a_1,...,a_s\) – линейно зависимы \(\Leftrightarrow\) хотя бы один из \(a_1,...,a_s\) линейно выражается через другие.
Сформулировать теорему о базисном миноре.	Утверждение (о базисном миноре). 1) Базисные строки (столбцы), соответствующие любому базисному минору M матрицы A л.н.з. 2) Строки (столбцы) матрицы A, не входящие в M являются линейной комбинацией базисных строк.
Сформулировать теорему о ранге матрицы.	Утверждение (теорема о ранге матрицы). Ранг матрицы равен максимальному числу её линейно независимых строк и равен максимальному числу линейно независимых столбцов.
Сформулировать критерий невырожденности квадратной матрицы.	Утверждение. Рассмотрим квадратную матрицу \(A \in M_n(\mathbb{R})\). Следующие три условия эквивалентны: (1) \(\det A \neq 0\) (2) \(\text{Rg } A = n\) (3) все строки A линейно независимы
Сформулировать теорему Кронекера–Капелли.	Утверждение. СЛАУ \(Ax = b\) совместна \(\Leftrightarrow \text{Rg } A = \text{Rg } (A | b)\).